{
	"game":{
        "revive_player_pos":false,
        "revive_times":4,
        "vision":3,
        "power_create_num":10,
		"timeout":800
	},
	"map":
	{
		"height":20,
		"width":20,
		"map_str":"
		.O........O........A
		##................##
		.<.2...2....2...2.>.
		v.2..............2.v
		........#...#.......
		......<<15551>>.....
		........#...#.......
		X..................X
		..<<<a...^....v...^.
		.v......^.^...v>..^.
		..>>>..>>>>>..v.>.^.
		.....v.v...v..v..>^.
		..<<<..v...v..v...^.
		X.................BX
		...2....#...#...2...
		..2...<<15551>>..2..
		^.2.....#...#....2.^
		.<.2............2.>.
		##................##
		b........O........O.
		"
	}
}