{
	"game":{
        "revive_player_pos":false,
        "revive_times":4,
        "vision":3,
        "power_create_num":10,
		"timeout":800
	},
	"map":
	{
		"height":20,
		"width":20,
		"map_str":"
		.O........O........A
..................##
...2...2....2...2.>.
..2......##......2.v
....................
.....^>>>>>>>>>.....
.....^.......Bv.....
X.1..^........v..2.X
..^..^..2112..v.....
.>.<.^..1551..v..v..
..^..^..1551..v.>.<.
.....^..2112..v..v..
X.2..^........v..2.X
.....^a.......v.....
.....<<<<<<<<<v.....
....................
^.2......##......2..
.<.2...2....2...2...
##..................
b........O........O.
		"
	}
}